3 3 3 3 3 3 1 1 1 1 5 5 5 2 1 4
3 3 3 3 1 1 1 1 2 2 5 5 5 2 1 4
3 1 1 1 1 1 1 2 5 5 5 5 2 2 1 4
1 1 1 1 1 1 2 5 5 5 5 5 2 1 1 4
1 1 1 1 1 2 5 5 5 5 5 5 2 1 1 4
1 1 1 1 2 5 5 5 5 5 5 2 2 3 1 1
1 1 1 2 5 5 5 5 5 5 2 2 3 3 1 4
1 1 2 5 5 5 5 5 5 2 2 3 3 3 3 4
1 2 5 5 5 5 5 5 2 2 2 3 3 3 3 4
2 2 5 5 5 5 5 2 2 3 3 3 3 1 1 4
2 5 5 5 5 2 2 2 3 3 1 1 1 1 1 4
5 5 5 5 2 1 1 1 1 1 1 1 1 1 1 4
