4 8 8 8 4 4 4 4 4 4 8 4 8 4 4 4 4 4 4 4 4 4 8 8 4 4 4 4 4 4 8 4 4 8 8 4 8 8 4 4 8 4 8 4 4 4 4 8 8 8
4 4 4 8 4 4 8 8 8 4 8 8 4 8 8 4 4 4 8 8 4 8 8 8 4 4 4 8 4 4 4 4 8 8 4 8 4 8 4 8 8 4 4 4 8 4 8 4 4 4
4 4 4 4 8 4 8 8 8 4 8 8 4 8 8 4 4 4 4 8 0 2 2 2 2 2 0 4 8 4 4 4 4 8 8 8 4 4 8 4 8 4 8 8 4 4 4 4 4 4
8 4 4 8 4 4 4 8 4 8 8 8 8 8 4 8 4 4 8 4 2 2 2 2 2 2 2 8 4 4 4 8 8 4 8 8 4 8 4 4 4 4 4 4 4 4 8 4 8 4
4 4 4 4 8 4 4 8 8 8 4 4 4 8 4 4 8 8 4 8 2 2 2 2 2 2 2 4 4 4 8 4 4 4 4 4 4 4 8 4 4 4 8 4 8 4 4 4 8 8
4 8 8 8 8 8 8 4 4 4 4 4 4 8 4 4 4 4 8 8 2 2 2 2 2 2 2 4 8 4 4 8 4 4 4 4 4 4 4 8 4 4 8 4 4 4 4 8 8 8
4 8 4 8 8 4 8 4 1 1 1 1 1 8 8 4 8 4 8 4 9 2 2 2 2 2 9 4 8 8 8 8 4 4 4 4 4 4 4 4 4 4 4 4 4 4 8 4 4 8
8 8 4 4 4 8 4 4 1 3 3 3 1 8 4 8 4 4 4 8 0 0 0 0 0 0 0 4 4 8 4 8 8 0 5 5 5 5 5 5 5 4 8 8 8 8 4 4 8 8
4 4 8 8 8 4 8 8 1 3 3 3 1 8 4 8 4 4 8 4 8 0 0 0 0 0 8 8 8 4 8 4 8 8 5 5 5 5 5 5 5 5 8 8 8 4 4 4 4 4
8 4 4 8 4 4 4 8 1 3 3 3 1 4 8 4 4 4 8 8 8 4 0 0 0 4 4 4 4 4 4 8 8 8 5 5 5 5 5 5 5 5 4 8 4 4 8 8 4 4
4 8 4 8 4 4 4 4 1 3 3 3 1 8 8 4 8 4 4 8 4 4 8 5 4 4 4 4 4 8 4 4 4 8 5 5 5 5 5 5 5 5 4 8 8 4 4 4 4 4
4 8 4 8 8 4 4 4 1 1 0 1 1 8 8 8 4 4 8 8 4 4 4 5 4 4 8 8 4 4 4 4 4 4 5 5 5 5 5 5 5 5 8 4 4 4 4 8 8 8
4 8 8 4 4 8 4 8 4 4 0 0 0 0 0 0 0 0 0 0 0 0 0 5 8 4 4 8 4 8 4 4 8 4 4 5 5 5 5 5 5 4 4 4 4 4 8 4 4 4
8 4 4 8 8 8 8 8 4 4 0 4 8 4 4 4 4 8 8 4 4 4 8 5 4 8 8 8 4 4 4 4 4 4 4 4 4 8 5 8 4 4 4 8 8 4 8 4 8 4
8 8 4 4 4 8 8 8 4 4 0 4 4 4 4 8 8 4 4 8 4 4 4 5 8 8 4 4 4 4 4 4 8 8 4 4 4 8 5 4 4 8 8 4 8 8 4 4 4 8
4 8 4 4 8 4 4 8 8 4 0 8 8 4 8 4 8 8 4 4 8 8 8 5 4 4 8 8 4 4 8 4 8 8 4 4 8 4 5 8 4 8 4 4 4 8 8 8 4 4
8 4 8 8 4 8 8 4 0 0 0 4 4 4 4 4 8 8 8 4 8 4 8 5 8 4 8 4 8 8 8 4 4 8 4 4 4 4 5 4 8 4 4 4 4 4 4 4 8 4
4 8 8 4 8 8 8 4 0 8 8 8 8 8 8 4 8 8 4 4 4 4 4 5 4 4 4 4 4 4 4 4 4 4 4 4 4 4 5 4 4 4 4 8 8 8 8 4 4 4
4 4 4 4 8 8 4 8 0 4 4 4 8 8 4 8 4 8 8 8 4 4 0 5 0 4 4 4 4 4 8 8 8 8 4 4 5 5 5 4 8 8 4 8 4 8 4 8 8 4
8 8 4 8 8 4 4 4 0 4 8 4 8 4 4 4 8 4 4 4 4 0 0 5 0 0 8 4 8 4 8 4 4 4 4 8 5 4 8 8 4 8 4 8 4 8 8 4 4 8
4 8 4 4 8 4 8 8 0 4 4 4 4 4 4 8 4 8 8 8 0 0 0 5 0 0 0 4 4 8 4 4 4 8 4 5 5 4 4 8 8 8 4 4 8 4 4 4 8 8
8 4 4 4 4 8 8 4 0 4 8 4 5 5 5 5 5 5 5 5 5 5 5 5 5 5 5 5 5 5 5 5 5 5 5 5 5 4 8 4 4 8 4 8 8 4 4 4 8 8
4 8 4 4 4 4 4 4 0 8 4 4 0 4 8 8 4 4 4 4 0 0 0 5 0 0 9 8 4 8 8 8 4 8 8 4 5 4 4 4 8 8 4 8 4 8 4 4 4 4
4 8 4 8 8 8 8 4 0 4 8 4 0 8 4 8 4 4 8 4 4 0 0 5 0 9 8 4 4 4 4 4 4 8 4 4 5 8 4 4 4 8 8 8 4 4 8 4 8 4
8 8 4 4 4 4 4 8 0 4 4 4 0 4 4 8 4 4 4 4 8 4 0 5 0 4 4 4 4 8 4 8 8 4 8 4 5 8 4 4 4 8 4 4 8 4 4 8 8 8
4 8 4 8 4 4 4 4 0 4 4 4 0 0 0 4 8 4 4 4 4 8 8 5 8 4 4 4 4 8 8 8 4 4 8 4 5 8 8 8 8 8 8 4 8 4 8 4 4 8
8 4 4 8 8 8 4 8 0 4 8 4 4 4 0 8 4 8 4 8 8 8 4 5 4 8 4 8 8 4 4 4 4 8 4 4 5 4 4 8 4 8 4 4 4 4 4 4 4 8
4 8 4 4 4 8 8 4 0 4 8 8 8 8 0 4 8 8 8 8 4 4 8 5 4 4 4 0 8 8 4 4 4 8 4 0 5 4 8 4 4 4 8 4 4 4 8 4 8 4
4 8 4 8 4 8 4 8 0 4 4 4 4 4 0 8 4 4 8 8 4 4 4 5 8 4 4 4 4 4 0 8 4 4 8 8 5 4 8 8 4 4 8 8 4 8 8 4 4 8
8 4 8 8 8 8 8 8 0 0 0 0 0 0 0 4 4 4 4 4 8 4 4 5 4 8 8 4 8 4 0 8 8 8 8 4 5 4 4 4 4 4 4 8 8 4 8 4 4 8
4 4 8 4 8 4 4 8 0 0 6 6 0 0 0 8 4 4 8 4 4 4 4 5 4 8 8 4 8 4 8 8 8 4 8 8 0 8 4 8 4 8 4 4 4 4 4 4 8 8
4 8 8 4 4 4 4 4 0 6 6 6 6 0 0 4 4 4 4 8 4 8 4 5 4 4 8 4 4 4 8 4 4 8 4 0 0 0 4 8 4 4 4 8 4 4 8 4 8 8
8 4 8 8 4 4 8 4 0 0 6 6 6 6 0 8 8 4 8 4 4 4 4 5 8 4 4 4 8 8 8 4 4 8 4 0 0 0 4 8 4 4 4 4 8 8 8 4 8 8
4 8 4 4 8 8 4 8 0 0 0 6 6 0 0 4 8 4 4 4 8 4 4 5 4 4 4 4 4 4 8 4 8 4 8 0 0 0 4 8 4 4 8 8 8 8 4 4 4 4
4 8 8 8 4 8 8 4 0 0 0 0 0 0 0 4 8 4 4 8 4 8 4 5 4 4 8 8 4 8 8 8 4 4 8 0 0 0 4 8 4 4 4 8 8 8 4 4 8 4
8 8 8 4 4 4 4 8 4 4 4 8 4 4 4 8 4 4 4 4 8 8 8 5 4 4 4 4 4 4 4 4 8 8 4 0 0 0 4 8 4 4 4 8 4 4 8 4 4 4
8 8 4 8 4 8 4 8 4 4 8 4 8 8 8 4 8 8 4 0 0 0 0 0 0 0 0 4 4 8 4 8 8 8 0 0 0 0 0 8 4 4 4 8 4 4 8 8 4 8
4 4 4 4 4 8 4 8 4 8 4 4 4 8 8 4 8 4 0 0 0 0 6 0 0 0 0 0 4 4 0 4 4 0 0 0 0 0 0 8 4 4 4 8 8 4 4 8 8 4
4 4 8 4 8 8 4 4 4 4 4 4 4 8 4 8 8 4 0 0 0 6 6 6 6 0 0 0 4 4 4 4 0 0 6 6 6 0 0 8 4 8 4 4 8 4 8 8 8 4
4 8 4 4 4 4 4 4 4 4 4 8 8 0 4 4 4 8 0 0 0 6 6 6 6 0 0 0 0 8 8 4 0 0 0 6 6 8 0 4 4 8 8 4 4 4 4 4 4 4
4 8 4 4 4 4 8 8 4 4 8 4 4 8 8 8 4 8 0 0 0 0 6 6 6 6 0 0 0 0 0 0 0 6 8 6 6 0 0 4 8 4 4 8 8 8 4 8 4 4
4 4 8 4 4 4 4 8 8 4 4 4 8 0 8 8 4 8 8 0 0 0 0 6 6 0 0 4 4 4 8 0 0 0 6 6 6 6 0 4 8 4 4 4 4 8 8 8 8 8
4 4 4 4 8 4 4 8 4 4 4 4 8 4 8 8 8 8 8 4 0 0 0 0 0 0 8 4 4 8 4 0 0 8 0 0 8 0 0 8 4 8 4 4 4 4 4 4 4 8
8 4 4 8 4 4 4 8 4 8 8 8 8 8 4 8 4 8 4 4 4 4 8 4 4 4 8 8 8 4 4 8 0 0 0 0 0 0 8 8 4 4 4 8 4 8 4 4 8 8
8 4 4 8 8 8 4 4 4 4 4 4 4 4 4 8 4 4 8 4 4 8 4 8 8 8 8 4 4 4 4 4 8 4 4 4 8 8 4 4 8 4 8 4 8 8 4 4 4 8
4 4 8 4 8 4 4 8 8 4 4 4 4 4 8 8 8 4 4 8 8 4 4 8 4 4 8 8 4 4 8 4 4 8 4 8 4 8 4 4 8 8 8 8 4 8 4 4 4 4
8 8 4 4 8 8 4 4 4 8 8 4 4 4 8 4 4 4 4 8 8 4 4 4 8 4 8 8 8 8 4 8 8 4 4 4 8 4 8 8 4 4 8 8 8 4 8 8 4 4
4 8 4 4 4 4 4 4 4 4 4 8 8 4 4 8 4 4 4 8 4 4 8 8 8 8 8 4 4 8 8 4 4 4 8 4 4 4 4 8 4 4 4 8 4 8 4 4 8 4
8 8 8 4 4 8 4 4 4 8 8 8 4 4 4 8 4 4 4 4 4 8 8 4 8 4 4 4 4 4 4 8 8 4 4 4 4 4 8 4 8 8 4 8 4 8 4 4 4 8
4 8 4 4 8 4 4 8 8 4 4 8 8 4 8 8 4 4 8 4 4 4 8 4 8 8 8 8 8 4 4 4 4 4 4 4 4 4 4 4 8 4 8 8 8 4 4 4 4 8
